"","id","x","u1","u2","w","e","z","y"
"1",1,4,10,1,0.138673711999964,-1.54669438175165,14,48.138673712
"2",2,10,3,2,-1.5974217855678,1.22069923353505,13,49.4025782144322
"3",3,2,9,5,-0.220150026953272,3.58421048081771,11,36.7798499730467
"4",4,4,7,4,-2.44200625689652,-0.727149840167178,11,36.5579937431035
"5",5,2,2,1,-0.996958126388705,-1.30995313364062,4,15.0030418736113
"6",6,6,3,1,-0.529188501233813,-2.23788416752075,9,34.4708114987662
"7",7,6,3,4,-0.80471908103803,0.499066447888594,9,34.195280918962
"8",8,3,4,1,0.0892963862251175,-2.92293078025971,7,26.0892963862251
"9",9,5,4,5,-0.612435388234064,0.584399688188429,9,33.3875646117659
"10",10,5,8,4,1.22162436358771,1.56633200292326,13,47.2216243635877
"11",11,2,8,1,-0.51898190350993,0.593177646217445,10,33.4810180964901
"12",12,2,7,1,0.791717811000158,-1.53833435934025,9,31.7917178110002
"13",13,6,6,1,3.18249514462229,-1.35703284696875,12,47.1824951446223
"14",14,3,10,5,-0.508857864938078,0.447683552866222,13,43.4911421350619
"15",15,5,9,3,0.265434449420469,3.01593206062635,14,49.2654344494205
"16",16,2,5,5,1.57182356441455,1.99382272747702,7,26.5718235644145
"17",17,4,3,5,-0.482898193882958,0.232829518542792,7,26.517101806117
"18",18,2,5,1,0.0118371616557267,3.74027157290362,7,25.0118371616557
"19",19,7,8,5,-0.841164942192539,0.495136641871788,15,53.1588350578075
"20",20,2,9,2,-0.281365017372084,-2.28554651621048,11,36.7186349826279
"21",21,5,8,2,0.48889633571662,-3.93666082105114,13,46.4888963357166
"22",22,8,3,4,-0.129611316719534,1.83554730839395,11,42.8703886832805
"23",23,3,10,3,0.322020017954944,-3.11499528747505,13,44.3220200179549
"24",24,6,9,3,-0.553052794288247,-0.726983570888451,15,52.4469472057118
"25",25,9,9,4,-0.276189461329025,0.602748859259045,18,64.723810538671
"26",26,8,1,1,1.9671127728619,2.02576905173962,9,38.9671127728619
"27",27,6,9,3,-0.228296485609081,3.56099626678926,15,52.7717035143909
"28",28,9,3,3,-1.86427755075324,-0.0198308765158331,12,45.1357224492468
"29",29,6,3,3,2.16750800215542,-2.56347071081804,9,37.1675080021554
"30",30,7,4,2,-0.103027279316666,2.59825119238249,11,41.8969727206833
"31",31,6,5,5,1.41210264078357,0.475962117987816,11,42.4121026407836
"32",32,8,5,5,0.286723093046936,2.38439775920622,13,49.2867230930469
"33",33,6,7,4,-0.0799028703550717,3.4941993329508,13,46.9200971296449
"34",34,2,10,3,0.212741642747537,-0.964896811302926,12,40.2127416427475
"35",35,3,4,1,-0.90305031201402,0.127948608785168,7,25.096949687986
"36",36,3,3,4,-0.26779942647839,1.49634437391694,6,22.7322005735216
"37",37,6,10,3,-1.03016540707976,0.904811556323666,16,54.9698345929202
"38",38,10,9,5,0.572682621997869,3.35671771403384,19,69.5726826219979
"39",39,7,5,5,-0.333660581957833,0.821635803949672,12,44.6663394180422
"40",40,2,6,3,-0.281342188836701,-1.96128526590745,8,27.7186578111633
"41",41,8,7,4,0.365804417027575,-0.443704432568555,15,55.3658044170276
"42",42,7,6,3,-1.482869672771,-0.225633290468075,13,46.517130327229
"43",43,4,7,5,-1.4948076978048,1.6696400132659,11,37.5051923021952
"44",44,1,10,3,-0.914961496715099,-0.110531860433278,11,35.0850385032849
"45",45,4,4,2,0.716755529989642,2.78931596191587,8,30.7167555299896
"46",46,10,2,1,-1.00869627559565,-0.551524134335179,12,46.9913037244043
"47",47,3,3,5,-0.776530912173972,-1.56636641810504,6,22.223469087826
"48",48,1,8,2,0.526817294293787,4.33533112534871,9,30.5268172942938
"49",49,9,4,2,0.574874794849057,-1.83743751753633,13,50.5748747948491
"50",50,1,8,2,0.0788870120421832,-3.39749778917738,9,30.0788870120422
"51",51,4,1,2,-0.667896835447236,-0.0379870952449115,5,20.3321031645528
"52",52,8,3,2,1.16920656864856,-2.29067674874651,11,44.1692065686486
"53",53,10,10,5,0.210928340505294,2.83467639847566,20,72.2109283405053
"54",54,10,6,5,-0.628871528504119,-0.766195922969819,16,59.3711284714959
"55",55,2,9,2,-0.304539520114174,-1.1952521791498,11,36.6954604798858
"56",56,5,5,5,1.00300054317336,-1.04164120465304,10,38.0030005431734
"57",57,3,10,2,-0.059152390596499,-1.90148169902985,13,43.9408476094035
"58",58,4,1,4,0.16843293565314,-2.11373102493894,5,21.1684329356531
"59",59,5,6,1,1.14802630510923,-3.23820889027602,11,41.1480263051092
"60",60,7,2,4,-1.32520792808112,1.61407042885662,9,34.6747920719189
"61",61,4,2,4,-1.71665707993977,-1.30248288556103,6,22.2833429200602
"62",62,8,5,1,-1.440103491745,1.42525360333418,13,47.559896508255
"63",63,10,6,4,-1.92714950624169,-1.46140897059475,16,58.0728504937583
"64",64,8,5,3,0.851589998481405,1.89055442103726,13,49.8515899984814
"65",65,6,4,1,-2.01932656016269,-0.704837455511959,10,35.9806734398373
"66",66,2,10,4,0.207534927044814,2.14156878435527,12,40.2075349270448
"67",67,4,4,1,0.036112103119908,1.1870345512545,8,30.0361121031199
"68",68,6,10,5,1.07616509285103,-4.72424257109965,16,57.076165092851
"69",69,6,9,5,0.308711468387331,-2.84503971430583,15,53.3087114683873
"70",70,2,9,2,0.149000698114306,1.03219479297025,11,37.1490006981143
"71",71,9,9,4,-0.991468750438737,1.38808519382416,18,64.0085312495613
"72",72,3,2,5,1.07507482320872,0.0693682869181134,5,21.0750748232087
"73",73,10,8,3,-2.02190221914552,2.56525466889511,18,63.9780977808545
"74",74,5,2,5,-0.196637527263561,5.8342816726099,7,27.8033624727364
"75",75,4,4,4,-0.970131699838161,-0.684881374656922,8,29.0298683001618
"76",76,5,7,2,-1.05119809556008,1.12344029872824,12,41.9488019044399
"77",77,6,8,5,-0.764430662205696,-3.44782455444649,14,49.2355693377943
"78",78,10,1,2,1.65095411657314,-0.238549452052569,11,46.6509541165731
"79",79,4,7,2,-0.0741796842787077,-1.77834343629465,11,38.9258203157213
"80",80,9,8,1,-0.0496645469702476,-1.73838919954038,17,61.9503354530298
"81",81,6,8,4,1.33463841415332,-1.11686129784507,14,51.3346384141533
"82",82,9,10,1,1.06050476226107,0.478665589680211,19,69.0605047622611
"83",83,7,9,3,1.28074808645871,1.18815376069127,16,58.2807480864587
"84",84,10,9,5,-0.210137046284063,0.698129727412807,19,68.7898629537159
"85",85,4,10,1,-0.851461840780906,3.45427022228828,14,47.1485381592191
"86",86,5,10,1,1.69951843919417,-2.02096680393301,15,53.6995184391942
"87",87,8,5,1,0.301721406664804,1.86994484975452,13,49.3017214066648
"88",88,7,6,5,0.0456019905757915,-4.34445325767232,13,48.0456019905758
"89",89,10,9,1,0.132782700882569,-3.03276444012419,19,69.1327827008826
"90",90,6,10,2,-1.5807059108843,-0.00642552675478811,16,54.4192940891157
"91",91,3,1,4,-1.22621329570936,-1.2368700312691,4,15.7737867042906
"92",92,10,7,4,-0.868337281260264,1.5005358201558,17,62.1316627187397
"93",93,3,5,2,0.236880195407038,0.389645302395838,8,29.236880195407
"94",94,10,9,1,1.3200795036435,-2.78656704898205,19,70.3200795036435
"95",95,7,3,2,0.586666182348931,-2.11121653571601,10,39.5866661823489
"96",96,5,9,2,-1.07006163084064,3.85672443690711,14,47.9299383691594
"97",97,9,1,5,-1.43908525859506,-0.971712379304452,10,39.5609147414049
"98",98,1,4,1,-1.16311401170766,-2.39774123483936,5,16.8368859882923
"99",99,5,2,3,-0.0992538652019382,0.594546734091205,7,27.9007461347981
"100",100,3,5,1,-0.112798425855318,-1.29671249062231,8,28.8872015741447
